year,team_id,team_name,wins,losses,ties,total_games
2017,26172,A&M-Corpus Chris,6,26,16,48
2017,2,Abilene Christian,23,16,13,52
2017,30123,Academy of Art,21,21,8,50
2017,929,Adams St.,15,23,12,50
2017,3,Adelphi,24,11,14,49
2017,4,Adrian,7,15,14,36
2017,11324,Agnes Scott,0,30,4,34
2017,5,Akron,16,21,19,56
2017,10,Ala.-Huntsville,31,11,11,53
2017,8,Alabama,36,7,13,56
2017,6,Alabama A&M,12,23,10,45
2017,7,Alabama St.,11,26,12,49
2017,14,Albany (NY),16,11,16,43
2017,13,Albany St. (GA),22,17,4,43
2017,2798,Albertus Magnus,14,6,18,38
2017,15,Albion,6,18,12,36
2017,16,Albright,9,9,18,36
2017,17,Alcorn,13,23,9,45
2017,934,Alderson Broaddus,9,14,16,39
2017,18,Alfred,13,9,18,40
2017,30170,Alfred St.,2,10,18,30
2017,19,Allegheny,6,16,14,36
2017,21,Alma,16,4,10,30
2017,938,Alvernia,14,10,14,38
2017,28746,Alverno,9,15,14,38
2017,22,American Int'l,12,11,14,37
2017,24,Amherst,17,6,12,35
2017,939,Anderson (IN),8,12,18,38
2017,13028,Anderson (SC),31,13,4,48
2017,25,Angelo St.,41,4,11,56
2017,26,Anna Maria,3,15,12,30
2017,27,Appalachian St.,12,24,14,50
2017,966,Arcadia,15,7,14,36
2017,29,Arizona,40,1,14,55
2017,28,Arizona St.,23,12,15,50
2017,8411,Ark.-Monticello,28,12,14,54
2017,2678,Ark.-Pine Bluff,10,22,9,41
2017,31,Arkansas,25,14,14,53
2017,947,Arkansas Tech,27,15,14,56
2017,33,Armstrong St.,27,10,2,39
2017,725,Army West Point,27,11,16,54
2017,35,Ashland,19,16,14,49
2017,36,Assumption,8,11,12,31
2017,37,Auburn,33,6,14,53
2017,38,Augsburg,16,12,12,40
2017,39,Augusta,9,39,4,52
2017,40,Augustana (IL),7,15,16,38
2017,41,Augustana (SD),24,10,18,52
2017,30093,AUM,20,15,8,43
2017,42,Aurora,20,5,16,41
2017,953,Austin,5,28,4,37
2017,43,Austin Peay,14,24,14,52
2017,44,Averett,24,18,1,43
2017,30146,Azusa Pacific,26,16,8,50
2017,45,Babson,15,9,12,36
2017,46,Baldwin Wallace,8,15,13,36
2017,47,Ball St.,25,18,11,54
2017,49,Barry,17,23,11,51
2017,15646,Barton,23,24,2,49
2017,58,Baruch,9,5,14,28
2017,50,Bates,5,7,12,24
2017,26520,Bay Path,10,11,15,36
2017,51,Baylor,35,6,13,54
2017,26107,Becker,6,10,16,32
2017,30197,Belhaven,11,19,6,36
2017,52,Bellarmine,18,24,12,54
2017,14927,Belmont,28,12,14,54
2017,2683,Belmont Abbey,7,25,8,40
2017,53,Beloit,5,21,10,36
2017,54,Bemidji St.,17,10,18,45
2017,55,Benedict,21,19,6,46
2017,296,Benedictine (IL),17,7,16,40
2017,56,Bentley,6,12,18,36
2017,30171,Berea,11,17,10,38
2017,973,Berry,32,2,3,37
2017,59,Bethany (WV),12,12,16,40
2017,30038,Bethany Lutheran,8,20,8,36
2017,60,Bethel (MN),7,12,21,40
2017,61,Bethune-Cookman,16,26,8,50
2017,62,Binghamton,10,17,21,48
2017,30220,Biola,3,2,1,6
2017,28593,Birmingham-So.,19,16,2,37
2017,30134,Black Hills St.,5,27,16,48
2017,64,Blackburn,4,10,18,32
2017,984,Bloomfield,14,11,16,41
2017,65,Bloomsburg,16,12,18,46
2017,985,Bluefield St.,1,23,8,32
2017,987,Bluffton,15,8,12,35
2017,66,Boise St.,24,12,14,50
2017,67,Boston College,23,14,16,53
2017,68,Boston U.,11,20,19,50
2017,69,Bowdoin,17,6,15,38
2017,70,Bowie St.,12,12,11,35
2017,71,Bowling Green,20,22,14,56
2017,72,Bradley,19,20,15,54
2017,73,Brandeis,8,7,20,35
2017,30094,Brevard,2,16,2,20
2017,74,Bridgeport,16,13,18,47
2017,75,Bridgewater (VA),8,22,8,38
2017,76,Bridgewater St.,9,13,16,38
2017,78,Brockport,12,10,16,38
2017,79,Brooklyn,2,14,16,32
2017,80,Brown,11,19,15,45
2017,81,Bryant,7,28,16,51
2017,83,Bucknell,21,10,13,44
2017,84,Buena Vista,14,10,12,36
2017,86,Buffalo,8,31,17,56
2017,85,Buffalo St.,7,15,14,36
2017,87,Butler,17,20,14,51
2017,77,BYU,28,10,16,54
2017,2685,BYU-Hawaii,10,24,10,44
2017,88,Cabrini,11,15,14,40
2017,1305,Cairn,9,9,14,32
2017,105,Cal Lutheran,10,14,12,36
2017,90,Cal Poly,28,10,15,53
2017,92,Cal St. Dom. Hills,6,37,10,53
2017,98,Cal St. East Bay,24,18,10,52
2017,97,Cal St. Fullerton,20,18,16,54
2017,30055,Cal St. Monterey Bay,34,7,12,53
2017,93,Cal St. San B'dino,27,15,12,54
2017,30198,Cal St. San Marcos,8,29,12,49
2017,995,Caldwell,23,10,18,51
2017,107,California,22,13,16,51
2017,106,California (PA),14,10,14,38
2017,30135,California Baptist,32,7,8,47
2017,114,Calvin,12,12,16,40
2017,996,Cameron,28,13,9,50
2017,115,Campbell,23,20,11,54
2017,116,Canisius,15,22,18,55
2017,117,Capital,17,9,14,40
2017,118,Carleton,10,12,14,36
2017,120,Carroll (WI),14,10,14,38
2017,1000,Carson-Newman,34,10,8,52
2017,121,Carthage,16,8,16,40
2017,123,Castleton,7,5,16,28
2017,1001,Catawba,10,33,8,51
2017,124,Catholic,16,10,10,36
2017,23624,Cazenovia,4,11,17,32
2017,14795,Cedar Crest,15,6,16,37
2017,30124,Cedarville,19,11,18,48
2017,125,Centenary (LA),11,19,8,38
2017,12884,Centenary (NJ),7,13,18,38
2017,126,Central (IA),22,4,14,40
2017,1004,Central Ark.,15,27,13,55
2017,127,Central Conn. St.,8,18,15,41
2017,129,Central Mich.,23,11,13,47
2017,130,Central Mo.,19,22,12,53
2017,1009,Central Okla.,36,8,8,52
2017,1010,Central Wash.,27,7,10,44
2017,132,Centre,20,16,3,39
2017,1012,Chadron St.,20,18,14,52
2017,133,Chaminade,6,32,10,48
2017,134,Chapman,13,13,12,38
2017,1013,Charleston (WV),26,11,16,53
2017,48,Charleston So.,20,27,12,59
2017,458,Charlotte,23,17,13,53
2017,10972,Chatham,4,19,12,35
2017,693,Chattanooga,12,27,12,51
2017,21323,Chestnut Hill,7,19,16,42
2017,137,Chicago,13,8,18,39
2017,95,Chico St.,29,8,12,49
2017,8875,Chowan,28,16,7,51
2017,139,Chris. Newport,22,8,4,34
2017,1015,Christian Bros.,6,35,9,50
2017,30058,Claflin,24,15,5,44
2017,142,Claremont-M-S,14,12,12,38
2017,143,Clarion,4,28,18,50
2017,145,Clark (MA),5,13,14,32
2017,144,Clark Atlanta,14,22,4,40
2017,958,Clarks Summit,6,16,12,34
2017,146,Clarkson,13,11,16,40
2017,148,Cleveland St.,4,34,17,55
2017,722,Coast Guard,13,13,9,35
2017,149,Coastal Caro.,27,13,14,54
2017,30083,Cobleskill St.,2,8,18,28
2017,150,Coe,22,5,11,38
2017,1023,Coker,35,13,4,52
2017,1014,Col. of Charleston,20,17,14,51
2017,151,Colby,7,12,13,32
2017,153,Colgate,8,20,16,44
2017,11403,Colo. Christian,23,17,12,52
2017,155,Colo. Sch. of Mines,22,12,12,46
2017,11416,Colorado Mesa,32,4,12,48
2017,156,Colorado St.,20,13,17,50
2017,2720,Colorado St.-Pueblo,14,22,12,48
2017,158,Columbia,12,18,18,48
2017,159,Columbus St.,26,20,7,53
2017,1028,Concord,21,21,14,56
2017,30199,Concordia (CA),29,12,11,52
2017,162,Concordia (NY),2,12,18,32
2017,24400,Concordia (TX),14,20,6,40
2017,160,Concordia Chicago,13,11,16,40
2017,30200,Concordia Portland,13,22,7,42
2017,1036,Concordia Wisconsin,18,6,16,40
2017,161,Concordia-M'head,8,16,18,42
2017,9081,Concordia-St. Paul,11,22,18,51
2017,8935,Converse,5,29,6,40
2017,165,Coppin St.,5,30,14,49
2017,167,Cornell,6,17,18,41
2017,166,Cornell College,14,7,16,37
2017,30111,Covenant,22,17,0,39
2017,169,Creighton,12,22,16,50
2017,30035,Crown (MN),8,18,10,36
2017,94,CSU Bakersfield,6,25,11,42
2017,101,CSUN,24,13,16,53
2017,170,Curry,10,14,10,34
2017,122,CWRU,14,9,14,37
2017,1059,D'Youville,6,12,18,36
2017,1044,Dallas,9,23,8,40
2017,2691,Daniel Webster,1,10,14,25
2017,172,Dartmouth,6,21,14,41
2017,30221,Davenport,4,1,0,5
2017,174,Davis & Elkins,13,15,16,44
2017,175,Dayton,19,17,18,54
2017,1050,Defiance,11,12,18,41
2017,180,Delaware,17,18,16,51
2017,178,Delaware St.,11,22,12,45
2017,179,Delaware Valley,4,7,16,27
2017,181,Delta St.,17,20,9,46
2017,182,Denison,19,9,10,38
2017,176,DePaul,18,16,15,49
2017,177,DePauw,7,14,18,39
2017,20,DeSales,9,15,14,38
2017,184,Detroit Mercy,8,26,17,51
2017,185,Dickinson,8,18,12,38
2017,30095,Dixie St.,32,9,10,51
2017,30118,Dominican (CA),18,26,6,50
2017,1332,Dominican (IL),18,8,14,40
2017,8956,Dominican (NY),15,13,17,45
2017,189,Drake,20,19,16,55
2017,190,Drew,4,14,18,36
2017,191,Drexel,9,17,24,50
2017,1057,Drury,17,22,16,55
2017,192,Dubuque,10,18,12,40
2017,196,East Carolina,20,23,11,54
2017,8965,East Central,21,21,11,53
2017,197,East Stroudsburg,10,17,16,43
2017,1062,East Tex. Baptist,27,6,6,39
2017,203,East. Mennonite,21,9,6,36
2017,8968,Eastern,3,20,13,36
2017,200,Eastern Conn. St.,6,12,18,36
2017,201,Eastern Ill.,23,16,17,56
2017,202,Eastern Ky.,15,22,18,55
2017,204,Eastern Mich.,14,22,14,50
2017,206,Eastern N.M.,18,30,10,58
2017,1064,Eastern Nazarene,12,9,18,39
2017,208,Eckerd,16,27,9,52
2017,1066,Edgewood,2,21,16,39
2017,209,Edinboro,11,12,16,39
2017,210,Elizabeth City St.,1,22,4,27
2017,211,Elizabethtown,4,20,14,38
2017,212,Elmhurst,10,12,16,38
2017,213,Elmira,4,7,12,23
2017,532,Elms,5,12,14,31
2017,1068,Elon,26,13,15,54
2017,9680,Embry-Riddle (FL),22,20,6,48
2017,214,Emerson,5,18,10,33
2017,30193,Emmanuel (GA),11,25,8,44
2017,215,Emmanuel (MA),7,11,16,34
2017,217,Emory,23,13,4,40
2017,216,Emory & Henry,24,10,6,40
2017,1071,Emporia St.,27,19,8,54
2017,8981,Endicott,7,13,14,34
2017,1072,Erskine,14,20,10,44
2017,198,ETSU,17,19,16,52
2017,218,Eureka,10,10,12,32
2017,219,Evansville,16,22,15,53
2017,220,Fairfield,13,20,16,49
2017,222,Fairleigh Dickinson,2,21,20,43
2017,1076,Fairmont St.,13,21,14,48
2017,27892,Farmingdale St.,11,11,16,38
2017,223,Fayetteville St.,15,15,6,36
2017,221,FDU-Florham,8,16,14,38
2017,23157,Felician,16,15,14,45
2017,224,Ferris St.,13,17,10,40
2017,225,Ferrum,20,15,5,40
2017,28755,FGCU,21,19,15,55
2017,1079,Findlay,18,16,10,44
2017,30032,Finlandia,16,11,7,34
2017,227,Fitchburg St.,7,11,18,36
2017,231,FIU,32,10,14,56
2017,229,Fla. Atlantic,25,15,16,56
2017,233,Fla. Southern,14,21,6,41
2017,30092,Flagler,31,18,4,53
2017,235,Florida,37,2,16,55
2017,228,Florida A&M,14,24,11,49
2017,234,Florida St.,38,1,16,55
2017,230,Florida Tech,23,22,6,51
2017,11538,Fontbonne,6,10,18,34
2017,236,Fordham,30,9,17,56
2017,9011,Fort Hays St.,11,35,10,56
2017,1083,Fort Lewis,5,32,12,49
2017,237,Fort Valley St.,3,26,2,31
2017,308,Fort Wayne,8,28,11,47
2017,238,Framingham St.,17,7,16,40
2017,1085,Francis Marion,27,19,2,48
2017,30069,Franciscan,8,10,18,36
2017,239,Frank. & Marsh.,7,15,14,36
2017,2694,Franklin,16,7,16,39
2017,241,Franklin Pierce,0,18,17,35
2017,242,Fredonia,11,11,18,40
2017,96,Fresno St.,24,15,16,55
2017,243,Frostburg St.,21,11,4,36
2017,244,Furman,21,16,14,51
2017,253,Ga. Southern,18,19,15,52
2017,1097,Ga. Southwestern,22,28,4,54
2017,245,Gallaudet,11,16,13,40
2017,246,Gannon,20,7,12,39
2017,1092,Gardner-Webb,11,25,10,46
2017,30084,Geneva,11,11,16,38
2017,1094,George Fox,18,14,2,34
2017,248,George Mason,11,24,19,54
2017,249,George Washington,20,17,15,52
2017,251,Georgetown,11,23,15,49
2017,257,Georgia,27,13,14,54
2017,1096,Georgia College,30,16,2,48
2017,254,Georgia St.,26,14,14,54
2017,255,Georgia Tech,12,27,14,53
2017,9004,Georgian Court,10,22,12,44
2017,258,Gettysburg,19,8,13,40
2017,1098,Glenville St.,11,26,17,54
2017,8366,Goldey-Beacom,7,18,23,48
2017,1099,Gordon,9,13,16,38
2017,261,Grambling,12,27,8,47
2017,1104,Grand Canyon,28,14,12,54
2017,262,Grand Valley St.,19,15,12,46
2017,794,Green Bay,2,21,17,40
2017,263,Greensboro,21,17,0,38
2017,1111,Greenville,11,8,18,37
2017,264,Grinnell,5,13,16,34
2017,265,Grove City,11,11,16,38
2017,1112,Guilford,25,11,4,40
2017,266,Gust. Adolphus,15,11,14,40
2017,12399,Gwynedd Mercy,10,11,12,33
2017,267,Hamilton,8,17,14,39
2017,268,Hamline,13,9,16,38
2017,270,Hampton,10,16,12,38
2017,1115,Hanover,13,7,12,32
2017,271,Hardin-Simmons,17,16,6,39
2017,1116,Harding,38,4,14,56
2017,272,Hartford,3,29,15,47
2017,275,Harvard,12,14,13,39
2017,276,Haverford,4,16,12,32
2017,277,Hawaii,23,14,15,52
2017,2697,Hawaii Hilo,20,19,10,49
2017,2696,Hawaii Pacific,20,18,10,48
2017,278,Heidelberg,18,9,15,42
2017,1123,Henderson St.,17,25,14,56
2017,1124,Hendrix,13,18,3,34
2017,8398,Hilbert,9,11,14,34
2017,280,Hillsdale,18,17,12,47
2017,281,Hiram,5,15,20,40
2017,283,Hofstra,14,17,18,49
2017,285,Holy Cross,5,19,18,42
2017,1126,Holy Family,13,13,20,46
2017,30175,Holy Names,4,32,12,48
2017,8404,Hood,13,12,12,37
2017,286,Hope,14,6,16,36
2017,30160,Houghton,7,15,16,38
2017,288,Houston,20,17,17,54
2017,287,Houston Baptist,12,19,12,43
2017,290,Howard,1,24,12,37
2017,2741,Howard Payne,5,27,8,40
2017,291,Humboldt St.,29,8,12,49
2017,292,Hunter,7,5,22,34
2017,1130,Huntingdon,17,24,1,42
2017,1133,Husson,16,8,16,40
2017,294,Idaho St.,11,17,14,42
2017,300,Ill. Wesleyan,17,7,14,38
2017,302,Ill.-Chicago,22,17,16,55
2017,30050,Ill.-Springfield,21,21,12,54
2017,301,Illinois,27,10,17,54
2017,297,Illinois Col.,11,7,16,34
2017,299,Illinois St.,19,16,16,51
2017,303,Immaculata,12,10,12,34
2017,2743,Incarnate Word,8,31,16,55
2017,306,Indiana,18,22,13,53
2017,307,Indiana (PA),12,13,16,41
2017,305,Indiana St.,17,19,19,55
2017,310,Iona,15,15,16,46
2017,312,Iowa,10,23,17,50
2017,311,Iowa St.,15,28,12,55
2017,30173,Iowa Wesleyan,8,12,14,34
2017,313,Ithaca,12,6,20,38
2017,2699,IUPUI,15,21,14,50
2017,314,Jackson St.,9,28,11,48
2017,316,Jacksonville,22,16,15,53
2017,315,Jacksonville St.,30,9,13,52
2017,317,James Madison,34,6,16,56
2017,320,John Carroll,14,10,12,36
2017,321,John Jay,3,13,14,30
2017,22626,Johnson & Wales (RI),18,5,14,37
2017,323,Johnson C. Smith,13,14,2,29
2017,324,Johnson St.,1,3,14,18
2017,325,Juniata,11,15,12,38
2017,326,Kalamazoo,10,12,16,38
2017,328,Kansas,21,19,13,53
2017,329,Kean,21,3,12,36
2017,330,Keene St.,9,8,18,35
2017,1157,Kennesaw St.,29,12,12,53
2017,331,Kent St.,15,21,18,54
2017,334,Kentucky,24,11,16,51
2017,332,Kentucky St.,12,18,6,36
2017,335,Kenyon,11,19,10,40
2017,1159,Keuka,9,5,24,38
2017,30047,Keystone,6,14,16,36
2017,30051,King (TN),25,17,8,50
2017,336,King's (PA),12,10,12,34
2017,337,Knox,1,15,16,32
2017,339,Kutztown,23,8,14,45
2017,333,Ky. Wesleyan,23,16,18,57
2017,1163,La Roche,8,15,14,37
2017,340,La Salle,14,16,17,47
2017,341,La Verne,19,7,12,38
2017,498,La.-Monroe,24,15,16,55
2017,342,Lafayette,4,16,21,41
2017,1162,LaGrange,11,21,4,36
2017,2746,Lake Erie,8,16,14,38
2017,344,Lake Forest,12,12,12,36
2017,1164,Lakeland,11,13,16,40
2017,346,Lamar University,20,20,14,54
2017,30085,Lancaster Bible,6,16,14,36
2017,1167,Lander,19,29,4,52
2017,347,Lane,15,13,7,35
2017,8486,Lasell,4,16,18,38
2017,348,Lawrence,11,11,14,36
2017,349,Le Moyne,18,13,13,44
2017,351,Lebanon Valley,17,9,12,38
2017,30013,Lee,29,13,9,51
2017,13302,Lees-McRae,14,30,2,46
2017,352,Lehigh,18,15,19,52
2017,279,Lehman,4,14,14,32
2017,350,LeMoyne-Owen,5,20,3,28
2017,1170,Lenoir-Rhyne,39,8,6,53
2017,24317,Lesley,6,13,15,34
2017,8490,LeTourneau,13,21,7,41
2017,354,Lewis,22,17,12,51
2017,22235,Lewis & Clark,9,20,2,31
2017,355,Liberty,27,16,12,55
2017,1174,Limestone,39,7,8,54
2017,356,Lincoln (MO),5,33,10,48
2017,357,Lincoln (PA),4,18,6,28
2017,1176,Lincoln Memorial,21,18,6,45
2017,30136,Lindenwood (MO),16,19,8,43
2017,1179,Linfield,30,6,4,40
2017,28600,Lipscomb,29,12,12,53
2017,361,LIU Brooklyn,16,24,13,53
2017,362,LIU Post,15,15,22,52
2017,359,Livingstone,0,16,5,21
2017,360,Lock Haven,15,15,16,46
2017,99,Long Beach St.,16,20,16,52
2017,363,Longwood,15,21,16,52
2017,364,Loras,20,6,10,36
2017,671,Louisiana,30,5,13,48
2017,1182,Louisiana Col.,24,9,6,39
2017,366,Louisiana Tech,26,14,15,55
2017,367,Louisville,22,12,15,49
2017,371,Loyola Chicago,18,17,17,52
2017,370,Loyola Marymount,14,25,12,51
2017,365,LSU,32,9,14,55
2017,30177,Lubbock Christian,26,14,11,51
2017,372,Luther,25,3,12,40
2017,373,Lycoming,15,7,14,36
2017,374,Lynchburg,26,10,4,40
2017,30065,Lyndon St.,0,2,18,20
2017,20794,Lynn,23,16,9,48
2017,376,Macalester,16,10,14,40
2017,377,MacMurray,1,24,12,37
2017,380,Maine,8,17,18,43
2017,30137,Malone,12,18,19,49
2017,1192,Manchester,7,15,13,35
2017,381,Manhattan,18,10,22,50
2017,382,Manhattanville,15,9,14,38
2017,384,Mansfield,17,8,12,37
2017,1194,Maranatha Baptist,2,12,17,31
2017,1196,Marian (WI),17,7,16,40
2017,385,Marietta,11,17,10,38
2017,386,Marist,20,13,22,55
2017,1199,Mars Hill,11,25,6,42
2017,388,Marshall,32,5,14,51
2017,8597,Martin Luther,10,11,14,35
2017,30075,Mary,11,26,18,55
2017,389,Mary Baldwin,7,25,0,32
2017,1203,Mary Hardin-Baylor,22,12,6,40
2017,390,Mary Washington,20,16,4,40
2017,392,Maryland,8,28,15,51
2017,395,Maryville (MO),17,21,12,50
2017,396,Maryville (TN),20,17,1,38
2017,397,Marywood,8,13,14,35
2017,399,Mass. Maritime,2,6,16,24
2017,400,Massachusetts,15,17,19,51
2017,773,McDaniel,12,11,17,40
2017,30138,McKendree,24,17,12,53
2017,486,MCLA,0,16,20,36
2017,402,McNeese,28,13,14,55
2017,379,Me.-Farmington,2,14,16,32
2017,30040,Me.-Presque Isle,9,7,10,26
2017,23725,Medaille,14,10,14,38
2017,404,Memphis,23,18,14,55
2017,406,Mercer,19,23,11,53
2017,407,Mercy,16,6,22,44
2017,408,Mercyhurst,8,22,17,47
2017,409,Meredith,27,15,1,43
2017,410,Merrimack,19,8,14,41
2017,411,Messiah,26,4,12,42
2017,412,Methodist,8,30,0,38
2017,414,Miami (OH),20,16,15,51
2017,418,Michigan,28,8,16,52
2017,416,Michigan St.,21,12,17,50
2017,419,Middle Tenn.,12,20,19,51
2017,420,Middlebury,8,7,17,32
2017,1222,Midwestern St.,17,23,6,46
2017,422,Miles,8,26,10,44
2017,423,Millersville,17,21,12,50
2017,424,Millikin,21,9,10,40
2017,426,Millsaps,23,10,5,38
2017,427,Minn. Duluth,26,10,18,54
2017,27854,Minn.-Crookston,11,22,19,52
2017,1226,Minn.-Morris,4,22,14,40
2017,428,Minnesota,35,3,16,54
2017,383,Minnesota St.,34,6,16,56
2017,30125,Minot St.,13,12,16,41
2017,16142,Misericordia,11,11,18,40
2017,429,Mississippi Col.,25,14,11,50
2017,430,Mississippi St.,29,13,13,55
2017,432,Mississippi Val.,9,25,12,46
2017,434,Missouri,23,16,14,53
2017,435,Missouri S&T,15,22,16,53
2017,669,Missouri St.,20,13,16,49
2017,398,MIT,15,3,14,32
2017,30042,Mitchell,7,12,12,31
2017,9012,Mo. Southern St.,22,25,8,55
2017,9013,Mo. Western St.,27,13,10,50
2017,436,Mo.-St. Louis,28,12,12,52
2017,437,Molloy,18,12,18,48
2017,439,Monmouth,12,20,20,52
2017,438,Monmouth (IL),10,9,16,35
2017,205,Mont. St. Billings,14,23,12,49
2017,441,Montana,21,19,14,54
2017,442,Montclair St.,14,12,12,38
2017,1238,Montevallo,20,20,4,44
2017,443,Moravian,22,2,14,38
2017,444,Morehead St.,20,16,17,53
2017,446,Morgan St.,17,11,13,41
2017,30067,Morrisville St.,0,12,22,34
2017,30036,Mount Aloysius,11,9,14,34
2017,27901,Mount Ida,7,10,18,35
2017,30033,Mount Mary,6,16,16,38
2017,1245,Mount Olive,24,26,2,52
2017,452,Mount Union,12,16,12,40
2017,20220,MSOE,17,7,16,40
2017,413,MSU Denver,30,13,12,55
2017,1240,MSU Moorhead,7,22,16,45
2017,8567,Mt. St. Joseph,14,10,14,38
2017,1468,Mt. St. Mary (NY),16,8,12,36
2017,450,Mt. St. Mary's,12,20,15,47
2017,451,Mt. St. Vincent,12,8,16,36
2017,453,Muhlenberg,9,13,16,38
2017,454,Murray St.,28,13,15,56
2017,455,Muskingum,11,17,12,40
2017,488,N.C. A&T,10,24,13,47
2017,489,N.C. Central,8,26,12,46
2017,491,N.C. Wesleyan,18,20,0,38
2017,8577,N.M. Highlands,15,26,12,53
2017,461,Nazareth,11,9,12,32
2017,462,Neb. Wesleyan,16,10,14,40
2017,1156,Neb.-Kearney,7,39,10,56
2017,463,Nebraska,16,20,16,52
2017,1254,Neumann,12,8,18,38
2017,466,Nevada,20,16,15,51
2017,467,New England Col.,6,14,14,34
2017,470,New Haven,21,8,12,41
2017,319,New Jersey City,7,11,20,38
2017,473,New Mexico,19,15,16,50
2017,472,New Mexico St.,17,17,14,48
2017,476,New Rochelle,8,2,16,26
2017,1257,Newberry,26,13,6,45
2017,21772,Newbury,10,11,15,36
2017,30054,Newman,11,30,11,52
2017,482,Niagara,9,15,22,46
2017,483,Nicholls St.,26,13,15,54
2017,484,Nichols,10,10,10,30
2017,485,Norfolk St.,9,18,12,39
2017,487,North Ala.,24,14,11,49
2017,457,North Carolina,31,11,13,55
2017,490,North Carolina St.,14,25,15,54
2017,492,North Central (IL),12,12,14,38
2017,30039,North Central (MN),0,22,12,34
2017,494,North Dakota,17,24,14,55
2017,493,North Dakota St.,17,23,14,54
2017,2711,North Florida,23,17,16,56
2017,30052,North Georgia,36,10,4,50
2017,9223,North Greenville,26,16,6,48
2017,496,North Park,6,26,8,40
2017,497,North Texas,21,17,17,55
2017,12810,Northeastern St.,23,22,6,51
2017,502,Northern Colo.,16,26,13,55
2017,503,Northern Ill.,18,15,14,47
2017,505,Northern Ky.,9,25,18,52
2017,1266,Northern St.,22,13,19,54
2017,1267,Northland,4,18,12,34
2017,507,Northwest Mo. St.,22,14,8,44
2017,1274,Northwest Nazarene,19,19,12,50
2017,509,Northwestern,15,20,17,52
2017,30178,Northwestern Okla.,13,29,14,56
2017,508,Northwestern St.,16,24,14,54
2017,30031,Northwestern-St. Paul,8,16,16,40
2017,510,Northwood,14,20,10,44
2017,511,Norwich,2,12,18,32
2017,513,Notre Dame,22,15,16,53
2017,8600,Notre Dame (MD),3,14,13,30
2017,30126,Notre Dame (OH),15,18,18,51
2017,30056,Notre Dame de Namur,8,27,7,42
2017,24639,Nova Southeastern,22,20,9,51
2017,1277,Nyack,5,25,16,46
2017,477,NYIT,12,12,16,40
2017,479,NYU,12,10,16,38
2017,514,Oakland,15,14,16,45
2017,1278,Oakland City,15,12,6,33
2017,515,Oberlin,9,19,12,40
2017,516,Occidental,9,17,12,38
2017,519,Ohio,26,10,14,50
2017,30119,Ohio Dominican,20,18,10,48
2017,517,Ohio Northern,20,8,10,38
2017,518,Ohio St.,23,9,16,48
2017,15207,Ohio Valley,8,16,21,45
2017,520,Ohio Wesleyan,8,14,14,36
2017,30202,Okla. Baptist,16,22,10,48
2017,30179,Okla. Christian,26,17,9,52
2017,24342,Okla. Panhandle,11,29,15,55
2017,522,Oklahoma,35,7,13,55
2017,521,Oklahoma St.,25,15,15,55
2017,524,Old Westbury,4,8,16,28
2017,433,Ole Miss,26,13,16,55
2017,525,Olivet,9,17,10,36
2017,464,Omaha,11,24,11,46
2017,529,Oregon,36,2,15,53
2017,528,Oregon St.,19,17,17,53
2017,530,Oswego St.,4,12,20,36
2017,531,Otterbein,22,5,12,39
2017,1289,Ouachita Baptist,16,26,14,56
2017,23008,Ozarks (AR),6,25,6,37
2017,533,Pace,12,12,15,39
2017,534,Pacific,18,21,12,51
2017,2751,Pacific (OR),8,26,4,38
2017,1297,Pacific Lutheran,17,13,4,34
2017,535,Paine,2,19,5,26
2017,30045,Palm Beach Atl.,25,15,9,49
2017,540,Penn,14,12,12,38
2017,30190,Penn College,10,5,20,35
2017,539,Penn St.,15,21,18,54
2017,30081,Penn St. Harrisburg,11,14,11,36
2017,30114,Penn St.-Abington,11,7,16,34
2017,25719,Penn St.-Altoona,11,11,12,34
2017,538,Penn St.-Behrend,13,11,16,40
2017,30044,Penn St.-Berks,9,7,16,32
2017,542,Pfeiffer,35,3,10,48
2017,543,Philadelphia U.,15,16,16,47
2017,21830,Piedmont,26,15,0,41
2017,544,Pine Manor,2,6,18,26
2017,1315,Pitt.-Bradford,7,20,14,41
2017,11839,Pitt.-Greensburg,12,14,12,38
2017,546,Pitt.-Johnstown,11,13,16,40
2017,1314,Pittsburg St.,34,12,10,56
2017,545,Pittsburgh,21,16,10,47
2017,547,Plattsburgh St.,16,10,14,40
2017,548,Plymouth St.,12,12,16,40
2017,549,Pomona-Pitzer,9,21,10,40
2017,550,Portland St.,6,25,14,45
2017,1318,Post,8,19,20,47
2017,553,Prairie View,18,19,10,47
2017,1320,Presbyterian,14,27,11,52
2017,554,Princeton,14,13,14,41
2017,555,Principia,4,8,16,28
2017,556,Providence,12,19,19,50
2017,557,Puget Sound,11,23,4,38
2017,30029,Purchase,3,9,14,26
2017,559,Purdue,16,27,12,55
2017,11504,Queens (NC),17,24,6,47
2017,560,Queens (NY),6,10,18,34
2017,561,Quincy,12,20,14,46
2017,562,Quinnipiac,16,17,18,51
2017,563,Radford,18,17,17,52
2017,564,Ramapo,16,6,14,36
2017,566,Randolph,22,14,4,40
2017,565,Randolph-Macon,25,7,4,36
2017,567,Redlands,12,18,10,40
2017,568,Regis (CO),23,21,12,56
2017,569,Regis (MA),7,7,16,30
2017,570,Rensselaer,14,4,20,38
2017,572,Rhode Island,6,22,18,46
2017,571,Rhode Island Col.,6,8,14,28
2017,573,Rhodes,20,17,3,40
2017,576,Rider,4,25,21,50
2017,577,Ripon,6,14,16,36
2017,580,RIT,16,7,16,39
2017,18422,Rivier,6,10,16,32
2017,578,Roanoke,19,13,6,38
2017,579,Robert Morris,12,23,14,49
2017,581,Rochester (NY),10,10,16,36
2017,582,Rockford,3,19,16,38
2017,1328,Rockhurst,24,16,14,54
2017,583,Roger Williams,16,11,13,40
2017,30180,Rogers St.,24,16,11,51
2017,584,Rollins,24,20,9,53
2017,585,Rose-Hulman,9,11,18,38
2017,15882,Rosemont,3,10,12,25
2017,259,Rowan,25,3,10,38
2017,586,Rust,0,17,6,23
2017,587,Rutgers,10,27,15,52
2017,588,Rutgers-Camden,11,13,12,36
2017,589,Rutgers-Newark,9,15,18,42
2017,11276,S.C. Aiken,20,22,7,49
2017,102,Sacramento St.,13,20,13,46
2017,590,Sacred Heart,9,18,19,46
2017,11036,Sage Colleges,10,12,18,40
2017,591,Saginaw Valley,24,9,14,47
2017,594,Saint Augustine's,14,9,4,27
2017,595,Saint Benedict,21,5,14,40
2017,600,Saint Francis (PA),31,9,16,56
2017,606,Saint Joseph's,14,20,16,50
2017,608,Saint Leo,34,7,9,50
2017,609,Saint Louis,15,18,17,50
2017,1343,Saint Martin's,16,12,11,39
2017,610,Saint Mary's (CA),15,22,13,50
2017,612,Saint Mary's (MN),7,18,15,40
2017,613,Saint Michael's,2,11,17,30
2017,617,Saint Peter's,2,19,18,39
2017,1347,Saint Rose,6,12,18,36
2017,30064,Saint Vincent,12,10,12,34
2017,30041,Salem,27,14,1,42
2017,19117,Salem Int'l,9,24,12,45
2017,621,Salem St.,14,6,16,36
2017,622,Salisbury,18,14,6,38
2017,623,Salve Regina,13,8,16,37
2017,624,Sam Houston St.,16,20,12,48
2017,625,Samford,16,25,13,54
2017,627,San Diego,16,16,12,44
2017,626,San Diego St.,20,14,15,49
2017,628,San Fran. St.,19,23,10,52
2017,630,San Jose St.,24,14,15,53
2017,631,Santa Clara,11,24,15,50
2017,30163,Sarah Lawrence,5,17,8,30
2017,632,Savannah St.,0,27,12,39
2017,1355,Schreiner,18,13,8,39
2017,633,Scranton,9,9,19,37
2017,1356,Seattle U,14,24,9,47
2017,635,Seton Hall,19,15,16,50
2017,30063,Seton Hill,12,16,14,42
2017,652,Sewanee,1,29,3,33
2017,676,SFA,13,25,12,50
2017,636,Shaw,6,24,6,36
2017,637,Shenandoah,10,24,6,40
2017,10870,Shepherd,23,12,14,49
2017,638,Shippensburg,19,16,12,47
2017,30151,Shorter,22,20,9,51
2017,639,Siena,8,20,24,52
2017,640,Simmons,9,12,16,37
2017,30127,Simon Fraser,8,22,10,40
2017,641,Simpson,5,19,10,34
2017,30128,Sioux Falls,22,18,16,56
2017,660,SIUE,32,7,15,54
2017,642,Skidmore,10,16,14,40
2017,643,Slippery Rock,9,16,16,41
2017,644,Smith,6,14,12,32
2017,645,Sonoma St.,30,12,12,54
2017,646,South Ala.,24,15,12,51
2017,648,South Carolina,23,16,15,54
2017,647,South Carolina St.,2,28,9,39
2017,650,South Dakota,13,24,14,51
2017,649,South Dakota St.,14,27,14,55
2017,651,South Fla.,24,19,12,55
2017,654,Southeast Mo. St.,17,18,15,50
2017,655,Southeastern La.,19,20,16,55
2017,1371,Southeastern Okla.,16,22,9,47
2017,1376,Southern Ark.,35,7,14,56
2017,658,Southern Conn. St.,5,20,13,38
2017,659,Southern Ill.,20,18,17,55
2017,661,Southern Ind.,34,8,14,56
2017,662,Southern Me.,8,8,18,34
2017,664,Southern Miss.,21,21,13,55
2017,468,Southern N.H.,15,11,18,44
2017,30152,Southern Nazarene,15,27,14,56
2017,665,Southern U.,11,12,11,34
2017,667,Southern Utah,9,21,13,43
2017,30164,Southern Va.,7,21,8,36
2017,1379,Southern Vt.,4,6,20,30
2017,30192,Southern Wesleyan,8,30,8,46
2017,2755,Southwest Baptist,26,14,12,52
2017,8736,Southwest Minn. St.,15,13,18,46
2017,8746,Southwestern (TX),18,10,8,36
2017,8744,Southwestern Okla.,14,24,14,52
2017,23260,Spalding,11,8,14,33
2017,30191,Spring Hill,30,15,4,49
2017,673,Springfield,21,3,14,38
2017,593,St. Anselm,5,9,18,32
2017,596,St. Bonaventure,9,24,20,53
2017,597,St. Catherine,19,9,12,40
2017,598,St. Cloud St.,23,15,18,56
2017,1334,St. Edward's,17,24,11,52
2017,9684,St. Elizabeth,3,17,16,36
2017,601,St. John Fisher,19,5,18,42
2017,603,St. John's (NY),19,12,16,47
2017,8687,St. Joseph (CT),11,5,20,36
2017,30072,St. Joseph's (Brkln),9,7,16,32
2017,604,St. Joseph's (IN),13,24,12,49
2017,1340,St. Joseph's (L.I.),12,8,14,34
2017,605,St. Joseph's (ME),8,10,18,36
2017,607,St. Lawrence,12,4,20,36
2017,8688,St. Mary's (IN),16,8,12,36
2017,1346,St. Mary's (TX),32,9,11,52
2017,614,St. Norbert,11,9,16,36
2017,615,St. Olaf,17,9,14,40
2017,618,St. Scholastica,15,11,14,40
2017,620,St. Thomas (MN),20,6,14,40
2017,1348,St. Thomas Aquinas,12,14,18,44
2017,674,Stanford,16,19,17,52
2017,103,Stanislaus St.,19,24,12,55
2017,675,Staten Island,15,3,18,36
2017,678,Stetson,24,11,12,47
2017,679,Stevens,18,10,12,40
2017,21852,Stevenson,6,18,12,36
2017,681,Stockton,12,12,14,38
2017,682,Stonehill,7,21,12,40
2017,683,Stony Brook,7,18,18,43
2017,684,Suffolk,9,11,16,36
2017,1390,Sul Ross St.,13,21,6,40
2017,30165,SUNY Canton,6,3,26,35
2017,168,SUNY Cortland,17,7,16,40
2017,247,SUNY Geneseo,11,5,22,38
2017,475,SUNY New Paltz,7,13,16,36
2017,526,SUNY Oneonta,16,6,16,38
2017,9500,SUNY Poly,5,9,20,34
2017,552,SUNY Potsdam,3,10,20,33
2017,685,Susquehanna,16,8,14,38
2017,686,Swarthmore,10,14,14,38
2017,687,Sweet Briar,0,22,4,26
2017,688,Syracuse,19,15,19,53
2017,689,Tampa,24,8,9,41
2017,1395,Tarleton St.,29,17,8,54
2017,712,TCNJ,11,11,10,32
2017,694,Tennessee,37,5,12,54
2017,691,Tennessee St.,9,27,15,51
2017,692,Tennessee Tech,13,22,13,48
2017,30090,Tex. A&M Int'l,13,25,13,51
2017,199,Tex. A&M-Commerce,26,15,12,53
2017,696,Tex. A&M-Kingsville,19,21,11,51
2017,30088,Tex. Permian Basin,8,33,11,52
2017,703,Texas,20,18,15,53
2017,697,Texas A&M,35,3,13,51
2017,1400,Texas Lutheran,30,4,4,38
2017,699,Texas Southern,15,12,13,40
2017,670,Texas St.,29,8,16,53
2017,700,Texas Tech,17,20,15,52
2017,701,Texas Woman's,24,15,11,50
2017,23121,Texas-Dallas,26,8,6,40
2017,30028,Texas-Tyler,31,2,6,39
2017,707,Thiel,10,14,12,36
2017,2758,Thomas (ME),3,13,16,32
2017,1402,Thomas More,17,7,14,38
2017,1403,Tiffin,15,20,16,51
2017,709,Toledo,18,25,14,57
2017,711,Towson,15,20,17,52
2017,28749,Transylvania,18,7,14,39
2017,30002,Trevecca Nazarene,19,20,14,53
2017,30037,Trine,24,2,10,36
2017,713,Trinity (CT),14,9,10,33
2017,715,Trinity (TX),13,19,8,40
2017,23413,Trinity Washington,1,7,10,18
2017,716,Troy,16,25,12,53
2017,499,Truman,28,16,12,56
2017,717,Tufts,14,6,14,34
2017,719,Tulsa,26,13,13,52
2017,12830,Tusculum,23,19,8,50
2017,720,Tuskegee,3,24,6,33
2017,1255,U New England,8,8,16,32
2017,9,UAB,13,26,14,53
2017,108,UC Davis,17,21,16,54
2017,111,UC Riverside,20,15,17,52
2017,112,UC San Diego,21,19,12,52
2017,104,UC Santa Barbara,22,19,16,57
2017,9754,UC-Colo. Springs,9,24,12,45
2017,128,UCF,21,18,11,50
2017,110,UCLA,28,10,17,55
2017,164,UConn,14,19,15,48
2017,309,UIndy,29,13,14,56
2017,401,UMass Boston,14,6,16,36
2017,656,UMass Dartmouth,14,12,13,39
2017,368,UMass Lowell,12,15,14,41
2017,391,UMBC,16,20,14,50
2017,393,UMES,10,14,15,39
2017,2707,UMKC,13,27,13,53
2017,537,UNC Pembroke,24,25,4,53
2017,459,UNCG,21,17,15,53
2017,460,UNCW,28,7,14,49
2017,504,UNI,20,15,15,50
2017,727,Union (NY),2,12,18,32
2017,30153,Union (TN),23,21,9,53
2017,465,UNLV,20,17,15,52
2017,728,Upper Iowa,11,23,16,50
2017,30104,Urbana,12,14,18,44
2017,730,Ursinus,11,15,12,38
2017,30140,Ursuline,11,13,18,42
2017,10411,USC Upstate,33,9,12,54
2017,28594,USciences,3,21,14,38
2017,702,UT Arlington,20,19,14,53
2017,695,UT Martin,30,12,14,56
2017,732,Utah,26,7,15,48
2017,731,Utah St.,25,9,14,48
2017,30024,Utah Valley,10,16,11,37
2017,704,UTEP,11,28,9,48
2017,733,Utica,9,11,16,36
2017,706,UTSA,16,24,13,53
2017,30181,UVa-Wise,20,14,14,48
2017,745,Va. Wesleyan,35,1,4,40
2017,734,Valdosta St.,29,12,11,52
2017,30166,Valley Forge,3,21,6,30
2017,735,Valparaiso,19,11,18,48
2017,739,Villanova,19,13,22,54
2017,746,Virginia,14,27,12,53
2017,743,Virginia St.,10,18,5,33
2017,742,Virginia Tech,16,24,15,55
2017,744,Virginia Union,6,14,5,25
2017,748,Wagner,13,18,12,43
2017,30141,Walsh,8,23,18,49
2017,750,Wartburg,15,11,12,38
2017,751,Wash. & Jeff.,1,14,16,31
2017,2814,Washburn,21,26,8,55
2017,756,Washington,29,9,15,53
2017,753,Washington Col.,18,14,8,40
2017,755,Washington-St. Louis,14,9,16,39
2017,757,Wayne St. (MI),28,10,10,48
2017,1433,Wayne St. (NE),8,30,16,54
2017,1434,Waynesburg,6,14,16,36
2017,758,Weber St.,21,13,16,50
2017,759,Webster,19,8,12,39
2017,760,Wellesley,11,4,14,29
2017,761,Wells,3,11,18,32
2017,762,Wentworth,0,17,18,35
2017,763,Wesley,17,15,6,38
2017,764,Wesleyan (CT),9,13,12,34
2017,14718,Wesleyan (GA),6,26,4,36
2017,358,West Ala.,18,23,11,52
2017,765,West Chester,27,7,13,47
2017,11740,West Florida,33,10,9,52
2017,766,West Ga.,22,19,11,52
2017,1438,West Liberty,11,19,15,45
2017,767,West Tex. A&M,32,6,11,49
2017,9630,West Va. Wesleyan,26,6,16,48
2017,1439,West Virginia St.,20,20,14,54
2017,769,Western Caro.,10,21,17,48
2017,770,Western Conn. St.,10,8,18,36
2017,771,Western Ill.,16,23,12,51
2017,772,Western Ky.,22,21,12,55
2017,774,Western Mich.,15,20,16,51
2017,1445,Western N.M.,1,37,10,48
2017,775,Western New Eng.,14,6,18,38
2017,1446,Western Ore.,14,14,10,38
2017,1448,Western Wash.,18,15,10,43
2017,777,Westfield St.,9,9,16,34
2017,1450,Westminster (MO),13,9,14,36
2017,1451,Westminster (PA),18,6,12,36
2017,778,Wheaton (IL),5,21,12,38
2017,779,Wheaton (MA),14,10,10,34
2017,12799,Wheeling Jesuit,15,15,15,45
2017,8896,Wheelock,1,17,12,30
2017,781,Whittier,12,16,12,40
2017,1454,Whitworth,30,6,4,40
2017,782,Wichita St.,23,14,17,54
2017,783,Widener,17,7,10,34
2017,784,Wilkes,16,8,14,38
2017,785,Willamette,13,17,4,34
2017,30120,William Jewell,19,17,16,52
2017,17094,William Peace,21,21,0,42
2017,789,Williams,14,9,14,37
2017,1460,Wilmington (DE),22,13,16,51
2017,1461,Wilmington (OH),5,23,10,38
2017,12973,Wilson,13,9,14,36
2017,1462,Wingate,23,19,8,50
2017,790,Winona St.,31,8,16,55
2017,791,Winston-Salem,10,26,8,44
2017,792,Winthrop,20,22,11,53
2017,8911,Wis. Lutheran,7,13,20,40
2017,793,Wis.-Eau Claire,17,7,14,38
2017,795,Wis.-La Crosse,18,10,10,38
2017,798,Wis.-Oshkosh,20,4,16,40
2017,799,Wis.-Parkside,13,21,14,48
2017,800,Wis.-Platteville,7,17,16,40
2017,801,Wis.-River Falls,8,15,14,37
2017,802,Wis.-Stevens Point,8,16,12,36
2017,803,Wis.-Stout,13,11,16,40
2017,804,Wis.-Superior,12,11,8,31
2017,805,Wis.-Whitewater,18,6,16,40
2017,796,Wisconsin,25,7,16,48
2017,806,Wittenberg,18,4,14,36
2017,787,Wm. Paterson,16,6,16,38
2017,807,Wooster,14,16,10,40
2017,809,Worcester St.,5,13,16,34
2017,808,WPI,14,10,12,36
2017,810,Wright St.,12,18,19,49
2017,813,Yale,9,21,16,46
2017,814,Yeshiva,2,10,12,24
2017,2730,York (NY),0,8,12,20
2017,815,York (PA),23,11,6,40
2017,30154,Young Harris,36,10,6,52
2017,817,Youngstown St.,16,22,19,57
